colorset AccentColor 修改为: DialectEmblazon
define DWDateLabelY 修改为: ZZDateStampPronounceWye
define DWDateViewHeight 修改为: ZZAppointmentOpinionTop
define DWDetailTextViewHeight 修改为: uLUkDWDetailTextViewHeightkULu
define DWDiaryAlertViewHeight 修改为: zcmGDWDiaryAlertViewHeightGmcz
define DWDiaryAlertViewWidth 修改为: pTncDWDiaryAlertViewWidthcnTp
define DWDiaryButtonSettingPadding 修改为: RJUCDWDiaryButtonSettingPaddingCUJR
define DWDiaryButtonSettingWidth 修改为: ZZDayReleaseCountersinkBreadth
define DWDiaryCalendarViewHeight 修改为: SkRSDWDiaryCalendarViewHeightSRkS
define DWDiaryContentViewHeight 修改为: ZZDaySubstanceCatchAcme
define DWDiaryContentViewWidth 修改为: ZZDayContentedViewBreadth
define DWDiaryNavigationBarHeight 修改为: ZZDaySailingStopPeak
define DWDiarySegmentY 修改为: fueEDWDiarySegmentYEeuf
define DWDiaryThemeBlueColor 修改为: byMUDWDiaryThemeBlueColorUMyb
define DWDiaryTipsViewHeight 修改为: WFZHDWDiaryTipsViewHeightHZFW
define DWDiaryTipsViewWidth 修改为: hiYmDWDiaryTipsViewWidthmYih
define DWDiaryTypingCalendarHeight 修改为: qGGLDWDiaryTypingCalendarHeightLGGq
define DWDiaryTypingCalenderSmallHeight 修改为: ifEcDWDiaryTypingCalenderSmallHeightcEfi
define DWDiaryTypingTextFieldHeight 修改为: pBEhDWDiaryTypingTextFieldHeighthEBp
define DWDiaryTypingTextViewHeight 修改为: ZZDayTypewritingSurveyElevation
define DWDiaryTypingToolBarHeight 修改为: wfrgDWDiaryTypingToolBarHeightgrfw
define DWDiaryTypingViewHeight 修改为: uCtODWDiaryTypingViewHeightOtCu
define DWDisKeyboardButtonGrayColor 修改为: ZZDisBurstGyColorlessness
define DWDisKeyboardButtonHeight 修改为: fmCjDWDisKeyboardButtonHeightjCmf
define DWDisKeyboardButtonWidth 修改为: ZZDisSwashUnbuttonWidth
define DWPasswordDisplayViewHeight 修改为: zvtjDWPasswordDisplayViewHeightjtvz
define DWPasswordDisplayViewTopPadding 修改为: ngKGDWPasswordDisplayViewTopPaddingGKgn
define DWPasswordDisplayViewWidth 修改为: jMLsDWPasswordDisplayViewWidthsLMj
define DWPasswordNumButtonLeftPadding 修改为: wofFDWPasswordNumButtonLeftPaddingFfow
define DWPasswordNumButtonMargin 修改为: ZZPasswordChineseReleaseLeeway
define DWPasswordNumButtonTopPadding 修改为: ZZPasswordMartialWhirligigEmbellish
define DWPasswordNumButtonWidth 修改为: tpuLDWPasswordNumButtonWidthLupt
define DWPasswordSpaceHeight 修改为: ZZWatchwordInfiniteSuperlative
define DWPasswordSpaceMargin 修改为: wbnGDWPasswordSpaceMarginGnbw
define DWPasswordSpaceWidth 修改为: PUVPDWPasswordSpaceWidthPVUP
define DWRGBA 修改为: WmvnDWRGBAnvmW
define DWRGBColor 修改为: ZZRepeatsColouring
define DWScreenHeight 修改为: RHhQDWScreenHeightQhHR
define DWScreenWidth 修改为: mjoXDWScreenWidthXojm
define DWSettingNavigationBarHeight 修改为: ZZReadyPilotageDebarTop
define DWSettingQuitButtonLeftPadding 修改为: ZZPoseDepartRemainingDramatize
define DWSettingQuitButtonWidth 修改为: SGmNDWSettingQuitButtonWidthNmGS
define PrefixHeader_pch 修改为: dwbtPrefixHeader_pchtbwd
define SECONDS_OF_ONE_DAY 修改为: NmCtSECONDS_OF_ONE_DAYtCmN
imageset bgImage 修改为: ZCsEBgImageEsCZ
imageset bg_main 修改为: bZAvBg_mainvAZb
imageset cloudy_blue 修改为: clearNaughty
imageset cloudy_highlight 修改为: jrPFCloudy_highlightFPrj
imageset cloudy_normal 修改为: DviKCloudy_normalKivD
imageset edit 修改为: AAZYEditYZAA
imageset happy_blue 修改为: tswNHappy_blueNwst
imageset happy_highlight 修改为: bciRHappy_highlightRicb
imageset happy_normal 修改为: wellChosenPattern
imageset icon-app 修改为: imageSynchronizer
imageset last 修改为: zVDLLastLDVz
imageset next 修改为: PPmAFutureAmPP
imageset normal_blue 修改为: YxOeNormal_blueeOxY
imageset normal_highlight 修改为: bWkjNormal_highlightjkWb
imageset normal_normal 修改为: NLhbNormal_normalbhLN
imageset quit 修改为: developer
imageset rain_blue 修改为: rainDownDownhearted
imageset rain_highlight 修改为: rainDownHighlighting
imageset rain_normal 修改为: rainDownNormal
imageset sad_blue 修改为: fZivSad_blueviZf
imageset sad_highlight 修改为: BTnGSad_highlightGnTB
imageset sad_normal 修改为: lamentableAbnormal
imageset save 修改为: IsIZSaveZIsI
imageset snow_blue 修改为: GXceSnow_blueecXG
imageset snow_highlight 修改为: MNGtSnow_highlighttGNM
imageset snow_normal 修改为: sllvSnow_normalvlls
imageset sunny_blue 修改为: izpFSunny_blueFpzi
imageset sunny_highlight 修改为: sunnyPlayUp
imageset sunny_normal 修改为: sunnyParanormal
imageset yes 修改为: gijtYestjig
protocol DWDiaryAlertDelegate 修改为: ZZDayAlarumDelegate
protocol DWDiaryContentViewDelegate 修改为: JMiuDWDiaryContentViewDelegateuiMJ
protocol DWDiaryEmotionSelectorDelegate 修改为: gbdvDWDiaryEmotionSelectorDelegatevdbg
protocol DWDiaryTypingCalendarDelegate 修改为: xSPmDWDiaryTypingCalendarDelegatemPSx
protocol DWDiaryTypingDelegate 修改为: ZZDayTypeDesignate
protocol DWDiaryWeatherSelectorDelegate 修改为: rloCDWDiaryWeatherSelectorDelegateColr
protocol DWPasswordViewControllerDelegate 修改为: yVAvDWPasswordViewControllerDelegatevAVy
protocol DWSettingSwitchCellDelegate 修改为: SgyfDWSettingSwitchCellDelegatefygS
protocol DWSettingViewControllerDelegate 修改为: HsvgDWSettingViewControllerDelegategvsH
头文件pch PrefixHeader 修改为: whHIPrefixHeaderIHhw
属性 alphaWindow 修改为: effectsWindowpane
属性 arrayDayDics 修改为: KrfCArrayDayDicsCfrK
属性 arrayDayViews 修改为: hgOsArrayDayViewssOgh
属性 arrayImageView 修改为: layOutFigurePurview
属性 arrayNumButton 修改为: regaliaWetButton
属性 buttonBackspace 修改为: qNepButtonBackspacepeNq
属性 buttonCloudy 修改为: DOvOButtonCloudyOvOD
属性 buttonDelete 修改为: euyzButtonDeletezyue
属性 buttonEdit 修改为: gOwfButtonEditfwOg
属性 buttonEmotion 修改为: UVVzButtonEmotionzVVU
属性 buttonHappy 修改为: fqTiButtonHappyiTqf
属性 buttonLast 修改为: YONWButtonLastWNOY
属性 buttonNext 修改为: TcqSButtonNextSqcT
属性 buttonNo 修改为: uiWmButtonNomWiu
属性 buttonNormal 修改为: unbuttonPattern
属性 buttonQuit 修改为: RhAcButtonQuitcAhR
属性 buttonRain 修改为: AhZpButtonRainpZhA
属性 buttonSad 修改为: QYjAButtonSadAjYQ
属性 buttonSave 修改为: PPpQButtonSaveQpPP
属性 buttonShare 修改为: buttonPercentage
属性 buttonSnow 修改为: AUVTButtonSnowTVUA
属性 buttonSunny 修改为: PhnPButtonSunnyPnhP
属性 buttonWeather 修改为: jYPiButtonWeatheriPYj
属性 buttonYes 修改为: qwhlButtonYeslhwq
属性 cellContentView 修改为: zpMVCellContentViewVMpz
属性 checker 修改为: CfxACheckerAxfC
属性 currentIndex 修改为: znxbCurrentIndexbxnz
属性 dateView 修改为: OkllDateViewllkO
属性 emotionSelectorView 修改为: dependentSelectorConsider
属性 isFull 修改为: AVMNIsFullNMVA
属性 isSettingMode 修改为: hbLFIsSettingModeFLbh
属性 ivEmotion 修改为: ivInches
属性 ivWeather 修改为: fourBraveOut
属性 laContext 修改为: FwnOLaContextOnwF
属性 labelDay 修改为: judgeNight
属性 labelDetail 修改为: DVhILabelDetailIhVD
属性 labelMessage 修改为: qKpkLabelMessagekpKq
属性 labelMonth 修改为: EmrQLabelMonthQrmE
属性 labelSmall 修改为: NIaOLabelSmallOaIN
属性 labelTime 修改为: zjtULabelTimeUtjz
属性 labelTitle 修改为: pronounceRubric
属性 labelWeek 修改为: jAoVLabelWeekVoAj
属性 labelWeekTime 修改为: xrAqLabelWeekTimeqArx
属性 labelYearMonth 修改为: ZZwkLabelYearMonthkwZZ
属性 leftButton 修改为: hhGXLeftButtonXGhh
属性 passwordDisplayView 修改为: paroleShowAspect
属性 rightButton 修改为: iCwKRightButtonKwCi
属性 switcher 修改为: CCmwSwitcherwmCC
属性 tFTitle 修改为: thymineFaradDeed
属性 tVDetail 修改为: tonneVPoint
属性 tipsView 修改为: hintAspect
属性 toolBar 修改为: peckerMeasure
属性 weatherSelectorView 修改为: GlxEWeatherSelectorViewExlG
文件夹修改 AccentColor.colorset 修改为: DialectEmblazon.colorset
文件夹修改 Assets.xcassets 修改为: Assets.xcassets
文件夹修改 Base.lproj 修改为: Base.lproj
文件夹修改 Calendar 修改为: Chinese
文件夹修改 Diary_WhatsUrName_.xcdatamodel 修改为: Diary_WhatsUrName_.xcdatamodel
文件夹修改 Diary_WhatsUrName_.xcdatamodeld 修改为: Diary_WhatsUrName_.xcdatamodeld
文件夹修改 Editor 修改为: OgxoEditoroxgO
文件夹修改 List 修改为: EtAoListoAtE
文件夹修改 Safe 修改为: Dependable
文件夹修改 Setting 修改为: xEEXSettingXEEx
文件夹修改 ZZMemorialDay 修改为: hkIBZZMemorialDayBIkh
文件夹修改 ZZMemorialDayTests 修改为: yHPvZZMemorialDayTestsvPHy
文件夹修改 ZZMemorialDayUITests 修改为: LfyrZZMemorialDayUITestsryfL
文件夹修改 bgImage.imageset 修改为: ZCsEBgImageEsCZ.imageset
文件夹修改 bg_main.imageset 修改为: bZAvBg_mainvAZb.imageset
文件夹修改 cloudy_blue.imageset 修改为: clearNaughty.imageset
文件夹修改 cloudy_highlight.imageset 修改为: jrPFCloudy_highlightFPrj.imageset
文件夹修改 cloudy_normal.imageset 修改为: DviKCloudy_normalKivD.imageset
文件夹修改 delete.imageset 修改为: delete.imageset
文件夹修改 edit.imageset 修改为: AAZYEditYZAA.imageset
文件夹修改 happy_blue.imageset 修改为: tswNHappy_blueNwst.imageset
文件夹修改 happy_highlight.imageset 修改为: bciRHappy_highlightRicb.imageset
文件夹修改 happy_normal.imageset 修改为: wellChosenPattern.imageset
文件夹修改 icon-app.imageset 修改为: imageSynchronizer.imageset
文件夹修改 image.imageset 修改为: image.imageset
文件夹修改 last.imageset 修改为: zVDLLastLDVz.imageset
文件夹修改 left.imageset 修改为: left.imageset
文件夹修改 next.imageset 修改为: PPmAFutureAmPP.imageset
文件夹修改 no.imageset 修改为: no.imageset
文件夹修改 normal_blue.imageset 修改为: YxOeNormal_blueeOxY.imageset
文件夹修改 normal_highlight.imageset 修改为: bWkjNormal_highlightjkWb.imageset
文件夹修改 normal_normal.imageset 修改为: NLhbNormal_normalbhLN.imageset
文件夹修改 point.imageset 修改为: point.imageset
文件夹修改 quit.imageset 修改为: developer.imageset
文件夹修改 rain_blue.imageset 修改为: rainDownDownhearted.imageset
文件夹修改 rain_highlight.imageset 修改为: rainDownHighlighting.imageset
文件夹修改 rain_normal.imageset 修改为: rainDownNormal.imageset
文件夹修改 right.imageset 修改为: right.imageset
文件夹修改 sad_blue.imageset 修改为: fZivSad_blueviZf.imageset
文件夹修改 sad_highlight.imageset 修改为: BTnGSad_highlightGnTB.imageset
文件夹修改 sad_normal.imageset 修改为: lamentableAbnormal.imageset
文件夹修改 save.imageset 修改为: IsIZSaveZIsI.imageset
文件夹修改 setting.imageset 修改为: setting.imageset
文件夹修改 share.imageset 修改为: share.imageset
文件夹修改 snow_blue.imageset 修改为: GXceSnow_blueecXG.imageset
文件夹修改 snow_highlight.imageset 修改为: MNGtSnow_highlighttGNM.imageset
文件夹修改 snow_normal.imageset 修改为: sllvSnow_normalvlls.imageset
文件夹修改 space.imageset 修改为: space.imageset
文件夹修改 sunny_blue.imageset 修改为: izpFSunny_blueFpzi.imageset
文件夹修改 sunny_highlight.imageset 修改为: sunnyPlayUp.imageset
文件夹修改 sunny_normal.imageset 修改为: sunnyParanormal.imageset
文件夹修改 yes.imageset 修改为: gijtYestjig.imageset
方法 buttonBackspaceTap 修改为: SiyJButtonBackspaceTapJyiS
方法 buttonDeleteTap 修改为: dKISButtonDeleteTapSIKd
方法 buttonEditTap 修改为: releaseDeleteTip
方法 buttonEmotionTap 修改为: zybgButtonEmotionTapgbyz
方法 buttonLastTap 修改为: buttonFinishKnock
方法 buttonNextTap 修改为: releaseFutureDab
方法 buttonNoPressed 修改为: ApCiButtonNoPressediCpA
方法 buttonNoTap 修改为: RMMVButtonNoTapVMMR
方法 buttonNumberTap 修改为: buttonComeRap
方法 buttonQuitTap 修改为: CzRtButtonQuitTaptRzC
方法 buttonSaveTap 修改为: bwYNButtonSaveTapNYwb
方法 buttonShareTap 修改为: unbuttonPartakeTap
方法 buttonWeatherTap 修改为: releaseBraveOutExploit
方法 buttonYesPressed 修改为: pushYesWeigh
方法 buttonYesTap 修改为: AqzzButtonYesTapzzqA
方法 checkPassword 修改为: moderateParole
方法 disappear 修改为: melt
方法 disappearFromBottomAnimated 修改为: disappearLensBottomlandDeaden
方法 disappearFromTopAnimated 修改为: yRZYDisappearFromTopAnimatedYZRy
方法 dismissView 修改为: disregardView
方法 handleTapGesture 修改为: bTOxHandleTapGesturexOTb
方法 leftButtonTap 修改为: SwRFLeftButtonTapFRwS
方法 minus 修改为: RMsgMinusgsMR
方法 plus 修改为: poEBPlusBEop
方法 rightButtonTap 修改为: BUxPRightButtonTapPxUB
方法 saveKeyIntoDataBase 修改为: redeemKeyStampDataPointHome
方法 setEmotionWithString 修改为: setPersonAnotherStrand
方法 setSwitcherValue 修改为: setStjzSwitcherValuezjtS
方法 setWeatherWithString 修改为: setJPcCWeatherWithStringCcPj
方法 showAnimated 修改为: HtjaShowAnimatedajtH
方法 switcherValueChanged 修改为: ipOVSwitcherValueChangedVOpi
方法 transformToNormalMood 修改为: metamorphosePrintedAbnormalMode
方法 transformToSmallMood 修改为: BYJhTransformToSmallMoodhJYB
方法 updateFrameWithDalta 修改为: LnKdUpdateFrameWithDaltadKnL
方法 updateKey 修改为: UoysUpdateKeysyoU
方法 updateUserInfoIntoDataBase 修改为: ydOSUpdateUserInfoIntoDataBaseSOdy
类名 DWDiaryAlertView 修改为: lWThDWDiaryAlertViewhTWl
类名 DWDiaryCalendarScrollView 修改为: SpDaDWDiaryCalendarScrollViewaDpS
类名 DWDiaryCalendarView 修改为: ZZDayObsEyeshot
类名 DWDiaryCellContentView 修改为: edLCDWDiaryCellContentViewCLde
类名 DWDiaryContentView 修改为: UlSsDWDiaryContentViewsSlU
类名 DWDiaryDismissKeyboardButton 修改为: ZZDayCanWsRelease
类名 DWDiaryEmotionSelectorView 修改为: lRwUDWDiaryEmotionSelectorViewUwRl
类名 DWDiaryLineImageView 修改为: ByQuDWDiaryLineImageViewuQyB
类名 DWDiaryTableViewCell 修改为: JiCBDWDiaryTableViewCellBCiJ
类名 DWDiaryTipsView 修改为: bvnsDWDiaryTipsViewsnvb
类名 DWDiaryTypingCalendarView 修改为: ERAJDWDiaryTypingCalendarViewJARE
类名 DWDiaryTypingView 修改为: aaklDWDiaryTypingViewlkaa
类名 DWDiaryWeatherSelectorView 修改为: sEyYDWDiaryWeatherSelectorViewYyEs
类名 DWPasswordChecker 修改为: YbsODWPasswordCheckerOsbY
类名 DWPasswordDisplayView 修改为: iQdBDWPasswordDisplayViewBdQi
类名 DWPasswordNumberButton 修改为: ZZWatchwordFigurePush
类名 DWPasswordViewController 修改为: ZZWatchwordSceneComptroller
类名 DWSettingStore 修改为: NfMTDWSettingStoreTMfN
类名 DWSettingSwitchTableViewCell 修改为: bjTFDWSettingSwitchTableViewCellFTjb
类名 DWSettingViewController 修改为: XbFSDWSettingViewControllerSFbX
类名 DWUserInfo 修改为: lUgwDWUserInfowgUl
类名修改 ZZMemorialDayTests 修改为: yHPvZZMemorialDayTestsvPHy
类名修改 ZZMemorialDayUITests 修改为: LfyrZZMemorialDayUITestsryfL
资源:png bgImage 修改为: ZCsEBgImageEsCZ
资源:png bg_main 修改为: bZAvBg_mainvAZb
资源:png cloudy_blue 修改为: clearNaughty
资源:png cloudy_highlight 修改为: jrPFCloudy_highlightFPrj
资源:png cloudy_normal 修改为: DviKCloudy_normalKivD
资源:png edit 修改为: AAZYEditYZAA
资源:png happy_blue 修改为: tswNHappy_blueNwst
资源:png happy_highlight 修改为: bciRHappy_highlightRicb
资源:png happy_normal 修改为: wellChosenPattern
资源:png icon-app 修改为: imageSynchronizer
资源:png last 修改为: zVDLLastLDVz
资源:png next 修改为: PPmAFutureAmPP
资源:png normal_blue 修改为: YxOeNormal_blueeOxY
资源:png normal_highlight 修改为: bWkjNormal_highlightjkWb
资源:png normal_normal 修改为: NLhbNormal_normalbhLN
资源:png quit 修改为: developer
资源:png rain_blue 修改为: rainDownDownhearted
资源:png rain_highlight 修改为: rainDownHighlighting
资源:png rain_normal 修改为: rainDownNormal
资源:png sad_blue 修改为: fZivSad_blueviZf
资源:png sad_highlight 修改为: BTnGSad_highlightGnTB
资源:png sad_normal 修改为: lamentableAbnormal
资源:png save 修改为: IsIZSaveZIsI
资源:png snow_blue 修改为: GXceSnow_blueecXG
资源:png snow_highlight 修改为: MNGtSnow_highlighttGNM
资源:png snow_normal 修改为: sllvSnow_normalvlls
资源:png sunny_blue 修改为: izpFSunny_blueFpzi
资源:png sunny_highlight 修改为: sunnyPlayUp
资源:png sunny_normal 修改为: sunnyParanormal
资源:png yes 修改为: gijtYestjig
